111111111111
100000E10001
1000P0C10001
10000C0001C1
111111111111