11111111
100000E1
1000P0C1
10000001
11111111