1111111111111111111111
1P00000000000000E10001
10000C1000100C00000001
10000C0001000CCC000001
1111111111111111111111